#######################
#.........#...........#
#.#.###.#.#.#.###.#.#.#
#.#.....#...#.....#.#.#
#.#.###.#####.###.#.#.#
#.....................#
#.#.###.#.###.#.###.#.#
#.#.# G #.....# G #.#.#
#.#.# # ####### # #.#.#
#..... #   P   # .....#
#######################